%%%%%%%%%%%%%%%%%%#%%%%%%%%%%%%%%%%%
%              %%%. %%%            %
%              %       %           % 
%              %%%   %%%           %
%    %%%                %%%%%%     %
%%   %  %%%%%%%%%%%%%%%%%      %%  %   
%  %  %%%%%%%%%%%%%%%%%%   %%%  %% % 
% %% %   %P %    %  %   %   %  %  %%
% %%% %  %  %    %  %   %   %   %  %
%    % % %  %    %  %   %   %    % %
%    % % %  % %   %   % %   %    % %
%    % % %  %  %  %  %   %% %   % %%
%     %% %  %%% % % % %%%  %%   % %%
%  %%% % % ....  ...%  ... %%   % % %
% %%%%   % .. .. ..    ... %%     % %
% %  %   % ...   ...   ... %%     % %
%% % %   %      % % % %%%% %      % %
%% % %   %%%   %  %  %    %      % %
%% % %   %  % %   %   % %       % %%
%%%% %   %  %  %%%%%   %       %  %
% %      %  %    %  %   %     %  % 
%  % %%  %  %    %  %   %   %   %
%    %   %  %    %  %   %%%%  %
%      %         %  %%%%%   %
%        %%%%         %%%%
%            %%%%%%%%%  
% 
% 
%
%  
%
% 
%
%
% 
%
%%%%%%%%%%%%%%%%%%%%%%%%%%%%%%%%%%%%%
